11100000110000000000
11100000110000000000
00000000110000000000
11111111111111111100
11111111111111111100
00000000110000000000
00011000110000000000
00011000110000000000
